{
    "name": "Level 1",
    "description": "The first level of the dungeon",
    "map": [
        [1, 1, 1, 1, 1, 1, 1, 1, 1, 1],
        [1, 0, 0, 0, 1, 0, 0, 0, 0, 1],
        [1, 0, 1, 0, 1, 0, 2, 1, 0, 1],
        [1, 0, 1, 0, 0, 0, 0, 0, 0, 1],
        [1, 0, 1, 1, 1, 1, 1, 1, 0, 1],
        [1, 0, 0, 0, 0, 0, 0, 1, 0, 1],
        [1, 1, 1, 1, 1, 0, 0, 0, 0, 1],
        [1, 0, 0, 0, 1, 0, 1, 1, 0, 1],
        [1, 0, 1, 0, 0, 0, 0, 0, 0, 1],
        [1, 0, 1, 0, 0, 0, 0, 0, 0, 1],
        [1, 0, 1, 0, 0, 0, 0, 0, 0, 1],
        [1, 0, 1, 0, 0, 0, 1, 0, 0, 1],
        [1, 0, 1, 0, 0, 0, 0, 0, 0, 1],
        [1, 0, 1, 0, 0, 0, 0, 0, 0, 1],
        [1, 0, 1, 0, 0, 1, 2, 0, 0, 1],
        [1, 0, 1, 0, 1, 0, 0, 0, 0, 1],
        [1, 0, 1, 0, 0, 0, 0, 0, 0, 1],
        [1, 0, 1, 0, 0, 0, 0, 2, 0, 1],
        [1, 0, 1, 0, 0, 0, 0, 0, 0, 1],
        [1, 1, 1, 1, 1, 1, 1, 1, 1, 1]
    ],
    "playerStart": {
        "x": 1,
        "z": 1,
        "direction": 0
    }
}